{
    "LevelList": [
        "first", "ihatemylife", "killmeplease"
    ],
    "Levels": [
        {
            "first": {
                "tiles": [
                    [1,1,1,1,1,1,1,1,1,1,1,1,1,1,1,1,1,1,1,1],
                    [1,0,0,0,0,0,0,0,0,0,0,0,0,0,0,0,0,0,0,1],
                    [1,0,0,1,1,1,0,0,0,0,0,0,0,0,0,0,0,0,0,1],
                    [1,0,1,1,1,1,0,0,0,0,0,0,0,0,0,0,0,0,0,1],
                    [1,0,0,0,1,1,0,0,0,0,0,0,0,0,0,0,0,0,0,1],
                    [1,0,0,0,1,1,0,0,0,0,0,0,0,0,0,0,0,0,0,1],
                    [1,0,0,0,1,1,0,0,0,0,0,0,0,0,0,0,0,0,0,1],
                    [1,0,0,0,1,1,0,0,0,0,0,0,0,0,0,0,0,0,0,1],
                    [1,0,1,1,1,1,1,1,0,0,0,0,0,0,0,0,0,0,0,1],
                    [1,0,1,1,1,1,1,1,0,0,0,0,0,0,0,0,0,0,0,1],
                    [1,0,0,0,0,0,0,0,0,0,0,0,0,0,0,0,0,0,0,1],
                    [1,0,0,0,0,0,0,0,0,0,0,0,0,0,0,0,0,0,0,1],
                    [1,0,0,0,0,0,0,0,0,0,0,0,0,0,0,0,0,0,0,1],
                    [1,0,0,0,0,0,0,0,0,0,0,0,0,0,0,0,0,0,0,1],
                    [1,0,0,0,0,0,0,0,0,0,0,0,0,0,0,0,0,0,0,1],
                    [1,1,1,1,1,1,1,1,1,1,1,1,1,1,1,1,1,1,1,1]
                ],
                "enemies": [
                    [12,15],
                    [5,3]
                ]
                "objective": [1,1],
                "start":[10,10]
            }
        },
        {
            "ihatemylife": {
                "tiles": [
                    [1,1,1,1,1,1,1,1,1,1,1,1,1,1,1,1,1,1,1,1],
                    [1,0,0,0,0,0,0,0,0,0,0,0,0,0,0,0,0,0,0,1],
                    [1,0,0,0,0,0,0,0,0,0,0,0,0,0,0,0,0,0,0,1],
                    [1,0,0,0,0,0,0,0,0,0,0,0,0,0,0,0,0,0,0,1],
                    [1,0,0,0,0,0,0,0,0,0,0,0,0,1,0,0,0,0,0,1],
                    [1,0,0,0,0,0,0,0,0,0,0,0,0,0,0,0,0,0,0,1],
                    [1,0,0,0,0,0,0,0,0,0,0,0,0,0,0,0,0,0,0,1],
                    [1,0,0,0,0,0,0,0,0,0,0,0,0,0,0,0,0,0,0,1],
                    [1,0,0,0,0,0,0,0,0,0,0,0,0,0,0,0,0,0,0,1],
                    [1,0,0,0,0,0,0,0,0,0,0,0,0,0,0,0,0,0,0,1],
                    [1,1,1,1,1,0,0,0,0,0,0,0,0,0,0,0,0,0,0,1],
                    [1,0,0,0,0,0,0,0,0,0,0,0,0,0,0,0,0,0,0,1],
                    [1,0,0,0,0,0,0,0,0,0,0,0,0,0,0,0,0,0,0,1],
                    [1,0,0,0,0,0,0,0,0,0,0,0,0,0,0,0,0,0,0,1],
                    [1,0,0,0,0,0,0,0,0,0,0,0,0,0,0,0,0,0,0,1],
                    [1,1,1,1,1,1,1,1,1,1,1,1,1,1,1,1,1,1,1,1]
                ],
                "enemies": [
                    [12,15],
                    [5,3]
                ]
                "objective": [13,18],
                "start":[1,1]
            }
        },
        {
            "killmeplease": {
                "tiles": [
                    [1,1,1,1,1,1,1,1,1,1,1,1,1,1,1,1,1,1,1,1],
                    [1,0,0,0,0,0,0,0,0,1,0,0,0,0,0,0,0,0,0,1],
                    [1,0,0,0,0,0,0,0,0,1,0,0,0,0,0,0,0,0,0,1],
                    [1,0,0,0,0,0,0,0,0,1,0,0,0,0,0,0,0,0,0,1],
                    [1,0,0,0,0,0,0,0,0,1,0,0,0,0,0,0,0,0,0,1],
                    [1,0,0,0,0,0,0,0,0,1,0,0,0,0,0,0,0,0,0,1],
                    [1,0,0,0,0,0,0,0,0,0,0,0,0,0,0,0,0,0,0,1],
                    [1,0,0,0,0,0,0,0,0,0,0,0,0,0,0,0,0,0,0,1],
                    [1,0,0,0,0,0,0,0,0,0,0,0,0,0,0,0,0,0,0,1],
                    [1,0,0,0,0,0,0,0,0,0,0,0,0,0,0,0,0,0,0,1],
                    [1,0,0,0,0,0,0,0,0,0,0,0,0,0,0,0,0,0,0,1],
                    [1,0,0,0,0,0,0,0,0,0,0,0,0,0,0,0,0,0,0,1],
                    [1,0,0,0,0,0,0,0,0,0,0,0,0,0,0,0,0,0,0,1],
                    [1,0,0,0,0,0,0,0,0,0,0,0,0,0,0,0,0,0,0,1],
                    [1,0,0,0,0,0,0,0,0,0,0,0,0,0,0,0,0,0,0,1],
                    [1,1,1,1,1,1,1,1,1,1,1,1,1,1,1,1,1,1,1,1]
                ],
                "enemies": [
                    [12,15],
                    [5,3]
                ]
                "objective": [4,4],
                "start":[13,18]
            }
        }
    ]
}